&&?&&&&&&&&&&
&222&222&222&
&2&2?2&2&2&2&
&22222&222?22C
&&&&&2&?&&&2&
2@222&22222&2&
&&&2&2&&?2&&&
&2&2&2&222&2C&
&2?2&2?2&&?2&
&22222&22222&
&&&?&&&&?&&&&