#####################
#000#00000#00000#0#0C#
#0#0#0###0#####0#0#0#
#0#0C#000#00000#0#0#0#
#0#######0#0###0#000#
#000000000#00000#0#0#
#0###0#####0#####0#0#
#0#000#000#0#00000#0#
#0#####0#0#0#0###0#00C
0@00000#0#0#0#0#0#0###
#00000#0#0#000#0#0C#0C#
#0#######0#####0#0#0#
#0000000#0000000#000#
#####################