111111111111111111111
1*******C1*******1*C**1
1*1111111*11111*1*1*1
1*******1*1***1*1*111
11111*1*1***1*1*1*1**C
1*****1*1*1*1*111*1*1
1111111*1*1*1*111*1*1
1*****1***1*1*****1*1
11111*11111*11111*1*1
*@*********1*****1*1*1
1*1111111*1*111*1*1*1
1*1*1***1*****1*1***1
1*1*1*111*11111*1*1*1
1***1*****1*****C1*1*1
111111111111111111111