---------------------
-0000000-0-00000-000-
-0-0---0-0-0---0-0-0-
-0-0C-000-00000-0-0-0C-
-0---0---0-----0-0---
-0-00000-00000-0-000-
---0-0-0-----0-----0-
-000-0-00000-0000000-
-0---0---0-------0---
-0-000-000-00000-0-00C
-0-----0---0---0-0-0-
0@000-00000-000-000-0-
---0-0---0---0-----0-
-000-0-000-000-000-0-
-0-----0---0---0-0-0-
-00000-00000-000-000-
-0-0-0-------0-------
-0-0-00000-000-00000-
-0-0-----0-0---0---0-
-0-00000C-0000000-0C00-
---------------------