===============================
=***********=************C=***=
=*===*=====*=*=====*===*===*=*=
=*=*****=*=***********=*=***=*=
=*=======*===*===*=======*=*=*=
*@*******=*=***=***=*****=*=*=*=
===*=====*===*===*=*===*=*===*=
=***********=***=*=*=*****=***=
=====*===*===*=====*=====*=*===
=*****=***=***=*=*****=*****=*=
=*=========*===*=*=====*=*=*=*=
=*=*********=***=*=*****=*=***=
===*=====*===*===*=*===*=*===*=
=***=***=*****=***=*=***=*=***=
=*=*===*===*===*=*===*===*=*===
=*=*****=***=***=*=***=***=***=
=*=*=========*=====*=*=*===*=*=
=*=***********=***=*=***=***=*=
=*=*===*===*===*=*===*===*=*===
=*****=*=*=*=***=***=***=*=*=*=
=====*=*=*=*===*=====*=*=*=*=*=
=*****=***=***=***=***=*=*=***=
=*===*=*=*=*===*===*===*=*=====
=*=*****=***=***=*=*=*=*=******C
=*=*=======*=*===*=*=*=*=======
=*=*=*****=***=***=*********=*=
=*=*=*=*=*===*=*=*=====*===*=*=
=*****=*C=***=***=***=*=*=***=*C=
=*=====*===*===*===*=*=*=*===*=
=*******=*****=*****=*********=
===============================